άτιμῶσαι - άτιμάσαι.

Alpa. αθρα. sicci. ἐρῶ cum compositis.
βούλομαι - βουλεύομαι.

δεκάζειν - δικάζειν.

διεωσάμην - διεσωσάμην.

δόξαν, δεδόχθαι - δεῖξαι, δεδεῖχθαι.
θξιίιτησεν -- ἔζητησεν.

ἐπέτειος - ἐνιαότινς. ,

ἕως - τόσας.

ἥδιον - θδινν.

ἠκκλησίαζον - ἒξεκλησόαζιν.

κρλάψαι , θκκιλάψαι - κόψαι, ἐκκόψαι.
κνριόσαι - κοσμῆσαι.

ληχθῆναι - λεχθῆναι, δειχθῆναι.

όμόσαι - ὁμολογῆσαι.

πάτριος - πατρῶινς.

 

πόλις - τιλιτεόα.
πράττει - προστάττω. τάττει.

τράγμα - πρόσταγμα.

ρρἶιν - όρίδινν.
σφόσιν - φησιν.

τό ταθόιν -τό μαθών.

τότθη - τάθη.

φαίνειν -Φόρειν et composita.

φθεόριι. περιφθεόρνμαι - Φέρει. τεριΦέρνμαι.

Φλαῦρνν -- Φαῦλνν.
quibus similia quilibet ex apparatu Oritico Platonis, Demosthe·
nis et eliorum plene manu adiicere peterit.

Inspiciamus ex his nonnulla paullo diligentius. ΑΙΡΩ ut
casus et fertum ferebat aut αθριι aut αἱρῶ scribebatur autin
ἐρῶ corrumpebatur, utini λόγος ἐρεῖ pre αἱρεῖ. Hinc sexcen-
ties inter se permiscentur αθρεσθαι, αἱρεῖσθαι, ἄρασθαι, άρεῖσθαι,
αἰρόμενος, ἐρόμενος et sim. in quibus omnibus quaa videtur

 

